3 4
Aly|the
ly |he 
y i|e c
 is| cu
is |cut
s t|ute
 th|tes
the|est
he |st 
e c|t g
 cu| gi
cut|gir
ute|irl
tes|rl 
est|l o
st | on
t g|on 
 gi|n p
gir| pl
irl|pla
rl |lan
l o|ane
 on|net
on |et 
n p|t E
 pl| Ea
pla|Ear
lan|art
ane|rth
net|th.
